#Programming, data mining, design
Kawa

#Mental support
Lancette2201
Letrune

#Translations
Hungarian:	Letrune
Dutch:	Kawa

#Ideas
0xb00b5	Andrea le Phrog
auyawolf	beargirlstink
bobvarioa	bossbutch
byzantineamber	Damonj17
delusionbait	demifiendcruithne
eggseventy	Foone
gryffintheparrotcat	jelloapocalypse
justmeemawthings	katzeregi
krusebruce	Lancette2201
Letrune	lizardywizard
lustrous-orb	mezzofurrte
mikailborg	natee22
Nidoskull	pontaoski
probablynothing	ray10k
razzdrgn	shiftergirlslappy
shrike-dyke	Siapran
spades-gameing	steellotus54
sweetcremereblogs	unusedcactus
yirrgzmb
howimportantisausernameanyway

#Villager designs
Anonymous	APL
archvillain	axollyon
Boorango	Calder Benson
ChaoGardener	Chuck Youngblood
D	Dave Jenkins
Doc	DuoRogue
eevee-williams	elric
everyone	FoolForBrightness
Foone	Friedslick6
J. A. Sablosky	Jayeaaaaa
JessicaIn3D	kaytypestar
Key3Kyo	Lancette2201
Laura	Letrune
LH	lizardywizard 
LucidPetals	Marquis
Marvel	metaregress
muffiln	natee22
North Greenfield	pelontrix/percival
pickled-fox	ratSprite
Renamon	Retrotude
riotmode	rknase
road-trip-girl	rz-053/Aldous
Skorvold	snurtle
steellotus54	thatguyoversea
The FOSS Community	Valoric Starlight
Weil	wyatt8740
yes	Zarky
zeemczed
; DROP TABLE villagers;--

#Cursors
Kenney (CC0)

#Music
JerryTerry

#Shaders
Based on works by
RJVB09	gre
jesstat	Matt DesLauriers

#Special thanks
Andrea le Phrog	Captain Jistuce
Cuyler	FloatyMonkey
Foone	Hunter R.
katepango	mikailborg
Omnitechnomancer	Screwtape
Vaartis	Vikxin
wareya

#Tooling
Heaven Tool by rafacasari
Switch Toolbox by KillzXGaming et al

#Third-party libraries
Dear ImGUI	Omar Cornut
FMOD Ex	Firelight Technologies
FMT	Victor Zverovich
GLAD	David Herberth
GLFW	Marcus Geelnard
	Camilla LÃ¶wy, et al
GLM	G-Truc Creation
Lua	PUC-Rio
MiniZ	Rich Geldreich
STB tools	Sean Barrett
Scale2X	Thomas Bernard
SimpleJSON	Mike Anchor
Sol	Rapptz
	ThePhD, et al
UFBX	Samuli Raivio
